GGGGGGGGGG
G        G
G        G
G   PS   G
G        G
GGGGGGGGGG