G                   G
G       PPPPP       G
G                   G
G                   G
G               PPPPG
G                   G
G   PPPP            G
G            PPPPPP G
G                   G
GGGGGGSGGGGGGGGGGGGGG