GGGGGGGGGG
G        G
G        G
G   PP   G
G        G
G        G
G        G
G  PP    G
G        G
G        G
G     PP G
G        G
G        G
G   PP   G
G        G
G        G
G PP     G
G        G
G        G
G      PPG
G        G
G        G
G  PP    G
G        G
G        G
G   PP   G
G        G
G        G
G    PP  G
G        G
G        G
G PP     G
G        G
G        G
G      PPG
G        G
G        G
G   PP   G
G        G
G        G
G PP     G
G        G
G        G
G      PPG
G        G
G        G
G  PS    G
GGGGGGGGGG