GGGGGGGGGGGGGGGGGGGGGGGGGGGGGGGGGGG
G                                 G
G                                 G
G                                 G
G                                 G
G  E                              G
G PPP                             G
G       PPPP                      G
G             PPPP                G
GGGGGGGGGGGGGGPPPP PPPP           G
G                       PPPP      G
G                                 G
G                                 G
G                           PPPP  G
G         P   PPP   G  PPP        G
G      P  P   PPP   G             G
G   P  P            G             G
G   P               G             G
GP                  G             G
GP                  G             G
G  P                G             G
G  P                G             G
G    P              G             G
G    P              G             G
G      PPP          G             G
G            PPP    G             G
G                   G             G
G                 PPG             G
G                   GGG           G
G              PP     G           G
G    PPP    GGGGGGGGG G           G
GP                  G G           G
GP                  G G           G
GPP                 G G           G
G   PPPP            G G           G
G          PPPPP    G G           G
G                  PG G           G
G                  PG G           G
G                 PPG G           G
G            PP   PPG G           G
G          P PP                   G
G      GGGGGGGGGGGGGGGGGGGGGGGGGGGG
G         G
GPPP      G
GPPP PSP  G
GGGGGGGGGGG