GGGGGGGGGG
G        G
G E      G
G   PS   G
G        G
GGGGGGGGGG